13 07 07 07 29 07 07 29 07 07 07 07 29 07 07 07 07 07 07 07 07 07 07 07 29 07 07 07 07 07 07 07 07 07 29 07 07 07 07 07 29 07 07 29 07 07 07 07 07 14
10 03 01 01 19 23 01 19 23 01 01 01 19 23 01 01 01 01 01 01 01 01 01 01 19 23 01 01 01 01 01 01 01 01 19 23 01 01 01 01 19 23 01 19 23 01 01 01 01 09
10 02 00 00 19 02 00 19 02 00 00 00 19 02 00 00 00 00 00 00 00 00 00 00 19 02 18 06 00 34 00 00 18 06 19 02 00 00 00 00 19 02 00 19 02 00 00 00 00 09
10 02 00 00 19 02 00 20 02 00 00 00 19 02 00 18 06 00 00 00 18 06 00 00 19 02 25 15 15 15 15 15 24 02 19 02 00 18 06 00 19 02 16 21 15 17 06 00 00 09
10 02 00 00 20 02 00 04 05 00 00 00 19 02 00 25 15 15 15 15 24 02 00 00 19 02 19 23 01 01 01 01 19 02 19 02 00 19 02 00 19 02 04 01 01 01 05 00 28 09
10 02 00 00 04 05 00 00 00 00 34 00 19 02 00 19 23 01 01 01 19 02 00 00 19 02 19 02 00 00 18 06 19 02 19 02 16 24 02 00 19 02 00 00 16 22 15 15 15 30
10 02 00 00 18 06 00 00 00 00 00 00 19 02 00 19 02 00 00 00 19 02 00 00 19 02 25 27 06 26 24 02 19 02 20 02 04 19 02 00 19 02 00 00 04 19 23 01 01 09
10 02 00 00 19 02 00 00 18 06 00 00 19 02 00 19 02 00 00 00 19 02 00 00 19 02 20 23 05 04 19 02 19 02 04 05 00 25 15 15 24 02 00 00 00 19 02 00 00 09
10 02 00 00 25 27 06 26 24 02 00 00 19 02 00 19 02 00 00 00 25 15 15 15 24 02 04 05 00 00 19 02 19 02 00 00 00 20 23 01 20 02 00 00 00 20 02 00 00 09
10 02 00 00 19 23 05 04 19 02 00 00 19 02 00 25 15 27 06 26 24 23 01 01 20 02 00 00 00 00 25 15 24 02 00 00 00 04 05 00 04 05 00 00 00 04 05 00 00 09
10 02 00 00 19 02 00 00 19 02 00 00 19 02 00 19 23 01 05 04 19 02 00 00 04 05 00 00 18 06 20 23 20 02 00 16 15 15 15 22 15 15 15 15 22 15 15 15 15 30
10 02 00 00 19 02 00 00 19 02 00 00 20 02 00 20 02 00 00 00 20 02 00 34 00 18 06 00 19 02 04 05 04 05 00 04 01 01 01 19 23 01 01 01 19 23 01 01 01 09
31 27 06 26 24 02 34 00 19 02 00 00 04 05 00 04 05 18 06 00 04 05 00 00 00 25 15 15 24 02 00 00 00 00 00 34 00 00 00 19 02 00 00 00 19 02 00 00 00 09
10 23 05 04 19 02 00 00 19 02 00 00 00 00 00 00 00 19 02 00 00 00 00 00 00 19 23 01 19 02 00 00 00 00 00 00 00 00 00 19 02 00 00 00 19 02 00 00 00 09
10 02 00 00 19 02 00 00 19 02 00 00 00 00 18 06 00 19 02 00 00 18 06 00 00 19 02 00 25 15 15 15 15 15 15 15 15 15 15 24 02 00 00 00 19 02 00 00 00 09
10 02 00 00 19 02 00 16 21 15 15 15 15 15 24 02 00 19 02 00 00 25 27 06 26 24 02 00 20 23 01 01 01 01 01 01 01 01 01 19 02 00 00 00 19 02 00 00 00 09
10 02 34 00 19 02 00 04 01 01 01 01 01 01 25 15 15 21 15 15 15 24 23 05 04 20 02 00 04 05 00 00 00 00 00 00 00 00 00 25 15 27 06 26 21 15 27 06 26 30
10 02 00 00 19 02 00 00 00 00 00 00 00 00 20 23 01 01 01 01 01 20 02 00 00 04 05 00 00 00 00 00 16 15 15 15 15 15 15 24 23 01 05 04 01 01 01 05 04 09
31 15 15 15 21 15 15 22 15 17 06 00 00 00 04 05 00 00 00 00 00 04 05 00 00 00 00 00 00 00 00 00 04 01 01 01 01 01 01 19 02 00 00 00 00 00 00 00 00 09
10 23 01 01 01 01 01 19 23 01 05 18 06 00 16 15 15 15 15 15 22 15 15 17 06 00 00 00 00 00 18 06 00 00 00 34 00 00 00 20 02 00 00 00 00 00 00 00 00 09
10 02 00 00 00 00 00 19 02 00 00 19 02 00 04 01 01 01 01 01 19 23 01 01 05 00 16 22 15 15 24 02 00 00 00 00 00 00 00 04 05 00 00 00 00 00 00 00 00 09
10 02 00 34 18 06 00 19 02 00 00 19 02 00 00 00 00 00 00 00 19 02 00 00 00 00 00 19 23 01 19 02 16 15 15 15 15 15 22 27 06 26 22 15 15 15 15 17 06 09
10 02 00 00 19 02 00 25 15 15 15 24 02 00 00 00 00 00 00 00 19 02 00 00 00 00 00 19 02 00 19 02 04 01 01 01 01 01 19 23 05 04 19 23 01 01 01 01 05 09
31 15 15 15 21 15 15 24 23 01 01 25 15 15 15 27 06 26 15 15 24 02 00 00 00 00 00 19 02 00 19 02 00 00 00 00 00 00 19 02 00 00 19 02 00 00 00 00 00 09
10 23 01 01 01 01 01 19 02 00 00 19 23 01 01 01 05 04 01 01 19 02 00 16 15 15 15 21 17 06 25 15 15 15 15 15 17 06 19 02 00 00 19 02 00 16 15 15 15 30
10 02 00 18 06 00 00 19 02 34 00 20 02 00 00 00 00 00 00 00 19 02 00 04 01 01 01 01 01 05 20 23 01 01 01 01 01 05 19 02 00 00 19 02 00 04 01 01 01 09
10 02 16 24 02 00 00 19 02 00 00 04 05 00 00 34 00 00 00 00 19 02 00 00 00 00 00 00 00 00 04 05 00 00 00 34 00 00 19 02 00 00 19 02 00 00 00 00 00 09
10 02 04 25 15 17 06 20 02 00 00 00 00 00 00 00 00 00 00 00 25 15 15 15 15 15 22 15 17 06 00 00 00 00 00 00 00 00 19 02 00 00 19 02 00 00 00 00 00 09
10 02 00 19 23 01 05 04 05 00 00 00 00 18 06 00 16 22 15 15 24 23 01 01 01 01 19 23 01 05 00 16 15 22 15 15 15 15 21 27 06 26 21 15 15 15 15 15 15 30
10 02 00 19 02 00 00 00 00 16 22 15 15 24 02 00 04 19 23 01 19 02 00 00 00 00 19 02 00 00 00 04 01 19 23 01 01 01 01 01 05 04 01 01 01 01 01 01 01 09
31 15 15 24 02 00 00 00 00 04 19 23 01 19 02 00 00 19 02 00 19 02 00 34 00 00 19 02 00 00 00 00 00 19 02 00 00 00 00 00 00 00 00 00 00 00 18 06 00 09
10 23 01 25 15 15 15 17 06 00 20 02 00 19 02 00 00 19 02 00 19 02 00 00 00 00 19 02 00 00 00 16 15 24 02 16 15 15 22 15 15 15 22 15 15 15 24 02 00 09
10 02 00 19 23 01 01 01 05 00 04 05 16 21 15 15 15 24 02 00 25 15 27 06 26 15 24 02 00 00 00 04 01 19 02 04 01 01 19 23 01 01 19 23 01 01 19 02 00 09
10 02 00 19 02 00 00 00 00 00 00 00 04 01 01 01 01 20 02 00 20 23 01 05 04 01 19 02 00 00 00 00 00 19 02 00 00 00 19 02 00 00 19 02 00 00 19 02 00 09
10 02 00 19 02 00 00 00 00 00 00 00 00 00 34 00 00 04 05 00 04 05 00 00 00 00 19 02 00 00 18 06 00 19 02 00 34 00 19 02 00 00 19 02 00 00 19 02 00 09
10 02 16 21 15 15 15 22 15 17 06 00 00 00 00 00 00 00 00 00 00 00 00 00 00 00 19 02 00 00 19 02 00 19 02 00 00 00 19 02 00 00 19 02 00 00 19 02 00 09
10 02 04 01 01 01 01 19 23 01 05 00 16 15 15 15 15 15 15 15 15 17 06 00 00 00 19 02 00 00 25 15 15 21 15 15 15 15 21 27 06 26 21 27 06 26 21 17 06 09
10 02 00 00 00 00 00 19 02 00 00 00 04 01 01 01 01 01 01 01 01 01 05 00 16 15 21 22 15 15 24 23 01 01 01 01 01 01 01 01 05 04 01 01 05 04 01 01 05 09
10 02 00 18 06 00 00 19 02 00 00 00 00 00 00 18 06 00 00 00 00 00 18 06 04 01 01 19 23 01 19 02 00 00 00 00 00 00 00 00 00 00 00 00 00 00 00 00 00 09
10 02 00 19 02 00 00 20 02 00 16 15 22 15 15 24 02 00 16 22 15 15 24 02 00 00 00 19 02 00 19 02 16 15 15 15 22 15 27 06 26 15 15 15 15 22 15 15 15 30
10 02 00 19 02 00 00 04 05 00 04 01 19 23 01 19 02 00 04 19 23 01 19 02 00 00 00 19 02 00 19 02 04 01 01 01 19 23 01 05 04 01 01 01 01 19 23 01 01 09
10 02 00 19 02 00 00 00 00 00 00 00 19 02 00 19 02 00 00 19 02 00 19 02 00 00 00 19 02 00 19 02 00 00 00 00 19 02 00 00 00 00 18 06 00 19 02 28 00 09
31 15 15 24 02 16 15 15 15 15 17 06 19 02 00 19 02 34 00 25 17 06 19 02 00 34 00 19 02 00 19 02 16 22 15 15 24 02 00 16 15 15 24 02 00 19 02 00 00 09
10 23 01 19 02 04 01 01 01 01 01 05 19 02 00 19 02 00 00 19 23 05 19 02 00 00 00 19 02 00 19 02 04 19 23 01 19 02 00 04 01 01 19 02 00 19 02 00 00 09
10 02 00 19 02 18 00 00 00 00 00 00 19 02 00 19 02 16 15 24 02 00 19 02 00 00 00 19 02 34 19 02 00 19 02 00 19 02 00 00 00 00 19 02 00 19 02 00 00 09
10 02 00 20 02 25 27 06 26 22 15 15 24 02 00 19 02 04 01 19 02 16 21 15 17 06 00 19 02 00 19 02 00 19 02 00 19 02 00 00 00 00 19 02 00 19 02 00 00 09
10 02 00 04 05 19 23 05 04 19 23 01 19 02 00 19 02 00 00 19 02 04 01 01 01 05 00 19 02 00 19 02 00 19 02 00 20 02 16 15 15 15 24 02 00 19 02 00 00 09
10 02 00 34 00 19 02 00 00 19 02 00 20 02 16 21 15 15 15 21 17 06 00 00 00 00 00 19 02 16 21 15 15 21 17 06 04 05 04 01 01 01 20 02 00 20 02 00 00 09
10 02 00 00 00 19 02 00 00 19 02 00 04 05 04 01 01 01 01 01 01 05 00 34 00 00 00 19 02 04 01 01 01 01 01 05 00 00 00 00 00 00 04 05 00 04 05 00 00 09
12 08 08 08 08 32 08 08 08 32 08 08 08 08 08 08 08 08 08 08 08 08 08 08 08 08 08 32 08 08 08 08 08 08 08 08 08 08 08 08 08 08 08 08 08 08 08 08 08 11