13 07 07 07 29 07 07 29 07 07 07 07 29 07 07 07 07 07 07 07 07 07 07 07 29 07 07 07 07 07 07 07 07 07 29 07 07 07 07 07 29 07 07 29 07 07 07 07 07 14
10 03 01 01 19 23 01 19 23 01 01 01 19 23 01 01 01 01 01 01 01 01 01 01 19 23 01 01 01 01 01 01 01 01 19 23 01 01 01 01 19 23 01 19 23 01 01 01 01 09
10 02 00 00 19 02 00 19 02 00 00 00 19 02 00 00 00 00 00 00 00 00 00 00 19 02 18 06 00 00 00 00 18 06 19 02 00 00 00 00 19 02 00 19 02 00 00 00 00 09
10 02 00 00 19 02 00 20 02 00 00 00 19 02 00 18 06 00 00 00 18 06 00 00 19 02 25 15 15 15 15 15 24 02 19 02 00 18 06 00 19 02 16 21 15 17 06 00 00 09
10 02 00 00 20 02 00 04 05 00 00 00 19 02 00 25 15 15 15 15 24 02 00 00 19 02 19 23 01 01 01 01 19 02 19 02 00 19 02 00 19 02 04 01 01 01 05 00 28 09
10 02 00 00 04 05 00 00 00 00 00 00 19 02 00 19 23 01 01 01 19 02 00 00 19 02 19 02 00 00 18 06 19 02 25 15 15 24 02 00 19 02 00 00 16 22 15 15 15 30
10 02 00 00 18 06 00 00 00 00 00 00 19 02 00 19 02 00 00 00 19 02 00 00 19 02 25 15 15 15 24 02 19 02 20 23 01 19 02 00 19 02 00 00 04 19 23 01 01 09
10 02 00 00 19 02 00 00 18 06 00 00 19 02 00 19 02 00 00 00 19 02 00 00 19 02 20 23 01 01 19 02 19 02 04 05 00 25 15 15 24 02 00 00 00 19 02 00 00 09
10 02 00 00 25 15 15 15 24 02 00 00 19 02 00 19 02 00 00 00 25 15 15 15 24 02 04 05 00 00 19 02 19 02 00 00 00 20 23 01 20 02 00 00 00 20 02 00 00 09
10 02 00 00 19 23 01 01 19 02 00 00 19 02 00 25 15 15 15 15 24 23 01 01 20 02 00 00 00 00 25 15 24 02 00 00 00 04 05 00 04 05 00 00 00 04 05 00 00 09
10 02 00 00 19 02 00 00 19 02 00 00 19 02 00 19 23 01 01 01 19 02 00 00 04 05 00 00 18 06 20 23 20 02 00 16 15 15 15 22 15 15 15 15 15 15 15 15 15 30
10 02 00 00 19 02 00 00 19 02 00 00 20 02 00 20 02 00 00 00 20 02 00 00 00 18 06 00 19 02 04 05 04 05 00 04 01 01 01 19 23 01 01 01 01 01 01 01 01 09
10 02 00 00 19 02 00 00 19 02 00 00 04 05 00 04 05 18 06 00 04 05 00 00 00 25 15 15 24 02 00 00 00 00 00 00 00 00 00 19 02 00 00 00 00 00 00 00 00 09
10 02 00 00 19 02 00 00 19 02 00 00 00 00 00 00 00 19 02 00 00 00 00 00 00 19 23 01 19 02 00 00 00 00 00 00 00 00 00 19 02 00 00 00 00 00 00 00 00 09
10 02 00 00 19 02 00 00 19 02 00 00 00 00 18 06 00 19 02 00 00 18 06 00 00 19 02 00 25 15 15 15 15 15 15 15 15 17 06 19 02 00 00 00 00 00 00 00 00 09
10 02 00 00 19 02 00 16 21 15 15 15 15 15 24 02 00 19 02 00 00 25 15 15 15 24 02 00 20 23 01 01 01 01 01 01 01 01 05 19 02 00 00 00 00 00 00 00 00 09
10 02 00 00 19 02 00 04 01 01 01 01 01 01 25 15 15 21 15 15 15 24 23 01 01 20 02 00 04 05 00 00 00 00 00 00 00 00 00 19 02 00 00 00 00 00 00 00 00 09
10 02 00 00 19 02 00 00 00 00 00 00 00 00 20 23 01 01 01 01 01 20 02 00 00 04 05 00 00 00 00 00 16 15 15 15 15 15 15 24 02 00 00 00 00 00 00 00 00 09
31 15 15 15 21 15 15 22 15 17 06 00 00 00 04 05 00 00 00 00 00 04 05 00 00 00 00 00 00 00 00 00 04 01 01 01 01 01 01 19 02 00 00 00 00 00 00 00 00 09
10 23 01 01 01 01 01 19 23 01 05 18 06 00 16 15 15 15 15 15 22 15 15 17 06 00 00 00 00 00 00 00 00 00 00 00 00 00 00 19 02 00 00 00 00 00 00 00 00 09
10 02 00 00 00 00 00 19 02 00 00 19 02 00 04 01 01 01 01 01 19 23 01 01 05 00 00 00 00 00 00 00 00 00 00 00 00 00 00 19 02 00 00 00 00 00 00 00 00 09
10 02 00 00 18 06 00 19 02 00 00 19 02 00 00 00 00 00 00 00 19 02 00 00 00 00 00 00 00 00 00 00 00 00 00 00 00 00 00 19 02 00 00 00 00 00 00 00 00 09
10 02 00 00 19 02 00 25 15 15 15 24 02 00 00 00 00 00 00 00 19 02 00 00 00 00 00 00 00 00 00 16 15 15 15 15 15 15 15 21 15 15 15 15 15 15 17 06 00 09
31 15 15 15 21 15 15 24 23 01 01 25 15 15 15 27 06 26 15 15 24 02 00 00 00 00 00 00 00 00 00 04 01 01 01 01 01 01 01 01 01 01 01 01 01 01 01 05 00 09
10 23 01 01 01 01 01 19 02 00 00 19 23 01 01 01 05 04 01 01 19 02 00 00 00 00 00 00 00 00 00 00 00 00 00 00 00 00 00 00 00 00 00 00 00 00 00 00 00 09
10 02 00 00 00 00 00 19 02 00 00 20 02 00 00 00 00 00 00 00 19 02 00 00 00 00 00 00 00 00 00 00 00 00 00 00 00 00 00 00 00 00 00 00 00 00 00 00 00 09
10 02 00 00 00 00 00 19 02 00 00 04 05 00 00 00 00 00 00 00 19 02 00 00 00 00 00 00 00 00 00 00 00 00 00 00 00 00 00 00 00 00 00 00 00 00 00 00 00 09
10 02 00 00 00 00 00 20 02 00 00 00 00 00 00 00 00 00 00 00 25 15 15 15 15 15 22 15 17 06 00 00 00 00 00 00 00 00 00 00 00 00 00 00 00 00 00 00 00 09
10 02 00 00 00 00 00 04 05 00 00 00 00 18 06 00 16 22 15 15 24 23 01 01 01 01 19 23 01 05 00 00 00 00 00 00 00 00 00 00 00 00 00 00 00 00 00 00 00 09
10 02 00 00 00 00 00 00 00 16 22 15 15 24 02 00 04 19 23 01 19 02 00 00 00 00 19 02 00 00 00 00 00 00 00 00 00 00 00 00 00 00 00 00 00 00 00 00 00 09
10 02 00 00 00 00 00 00 00 04 19 23 01 19 02 00 00 19 02 00 19 02 00 00 00 00 19 02 00 00 00 00 00 00 00 00 00 00 00 00 00 00 00 00 00 00 00 00 00 09
10 02 00 00 00 00 00 00 00 00 20 02 00 19 02 00 00 19 02 00 19 02 00 00 00 00 19 02 00 00 00 00 00 00 00 00 00 00 00 00 00 00 00 00 00 00 00 00 00 09
10 02 00 00 00 00 00 00 00 00 04 05 16 21 15 15 15 24 02 00 19 02 00 00 00 00 19 02 00 00 00 00 00 00 00 00 00 00 00 00 00 00 00 00 00 00 00 00 00 09
10 02 00 00 00 00 00 00 00 00 00 00 04 01 01 01 01 20 02 00 20 02 00 00 00 00 19 02 00 00 00 00 00 00 00 00 00 00 00 00 00 00 00 00 00 00 00 00 00 09
10 02 00 00 00 00 00 00 00 00 00 00 00 00 00 00 00 04 05 00 04 05 00 00 00 00 20 02 00 00 00 00 00 00 00 00 00 00 00 00 00 00 00 00 00 00 00 00 00 09
10 02 00 00 00 00 00 00 00 00 00 00 00 00 00 00 00 00 00 00 00 00 00 00 00 00 04 05 00 00 00 00 00 00 00 00 00 00 00 00 00 00 00 00 00 00 00 00 00 09
10 02 00 00 00 00 00 00 00 00 00 00 00 00 00 00 00 00 00 00 00 00 00 00 00 00 00 00 00 00 00 00 00 00 00 00 00 00 00 00 00 00 00 00 00 00 00 00 00 09
10 02 00 00 00 00 00 00 00 00 00 00 00 00 00 00 00 00 00 00 00 00 00 00 00 00 00 00 00 00 00 00 00 00 00 00 00 00 00 00 00 00 00 00 00 00 00 00 00 09
10 02 00 00 00 00 00 00 00 00 00 00 00 00 00 00 00 00 00 00 00 00 00 00 00 00 00 00 00 00 00 00 00 00 00 00 00 00 00 00 00 00 00 00 00 00 00 00 00 09
10 02 00 00 00 00 00 00 00 00 00 00 00 00 00 00 00 00 00 00 00 00 00 00 00 00 00 00 00 00 00 00 00 00 00 00 00 00 00 00 00 00 00 00 00 00 00 00 00 09
10 02 00 00 00 00 00 00 00 00 00 00 00 00 00 00 00 00 00 00 00 00 00 00 00 00 00 00 00 00 00 00 00 00 00 00 00 00 00 00 00 00 00 00 00 00 00 00 00 09
10 02 00 00 00 00 00 00 00 00 00 00 00 00 00 00 00 00 00 00 00 00 00 00 00 00 00 00 00 00 00 00 00 00 00 00 00 00 00 00 00 00 00 00 00 00 00 00 00 09
10 02 00 00 00 00 00 00 00 00 00 00 00 00 00 00 00 00 00 00 00 00 00 00 00 00 00 00 00 00 00 00 00 00 00 00 00 00 00 00 00 00 00 00 00 00 00 00 00 09
10 02 00 00 00 00 00 00 00 00 00 00 00 00 00 00 00 00 00 00 00 00 00 00 00 00 00 00 00 00 00 00 00 00 00 00 00 00 00 00 00 00 00 00 00 00 00 00 00 09
10 02 00 00 00 00 00 00 00 00 00 00 00 00 00 00 00 00 00 00 00 00 00 00 00 00 00 00 00 00 00 00 00 00 00 00 00 00 00 00 00 00 00 00 00 00 00 00 00 09
10 02 00 00 00 00 00 00 00 00 00 00 00 00 00 00 00 00 00 00 00 00 00 00 00 00 00 00 00 00 00 00 00 00 00 00 00 00 00 00 00 00 00 00 00 00 00 00 00 09
10 02 00 00 00 00 00 00 00 00 00 00 00 00 00 00 00 00 00 00 00 00 00 00 00 00 00 00 00 00 00 00 00 00 00 00 00 00 00 00 00 00 00 00 00 00 00 00 00 09
10 02 00 00 00 00 00 00 00 00 00 00 00 00 00 00 00 00 00 00 00 00 00 00 00 00 00 00 00 00 00 00 00 00 00 00 00 00 00 00 00 00 00 00 00 00 00 00 00 09
10 02 00 00 00 00 00 00 00 00 00 00 00 00 00 00 00 00 00 00 00 00 00 00 00 00 00 00 00 00 00 00 00 00 00 00 00 00 00 00 00 00 00 00 00 00 00 00 00 09
12 08 08 08 08 08 08 08 08 08 08 08 08 08 08 08 08 08 08 08 08 08 08 08 08 08 08 08 08 08 08 08 08 08 08 08 08 08 08 08 08 08 08 08 08 08 08 08 08 11