13 07 07 07 07 07 07 07 07 07 07 07 07 07 07 07 07 07 07 07 07 07 07 07 07 07 07 07 07 07 07 07 07 07 07 07 07 07 07 07 07 07 07 07 07 07 07 07 07 14
10 03 01 01 01 01 01 01 01 01 01 01 01 01 01 01 01 01 01 01 01 01 01 01 01 01 01 01 01 01 01 01 01 01 01 01 01 01 01 01 01 01 01 01 01 01 01 01 01 09
10 02 00 00 00 00 00 00 00 00 00 00 00 00 00 00 00 00 00 00 00 00 00 00 00 00 00 00 00 00 00 00 00 00 00 00 00 00 00 00 00 00 00 00 00 00 00 00 00 09
10 02 00 16 15 15 15 15 15 15 15 15 15 17 06 00 00 00 00 00 00 00 00 00 00 00 00 00 00 00 00 00 00 00 00 00 00 00 00 00 00 00 00 00 00 00 00 00 00 09
10 02 00 04 01 01 01 01 01 01 01 01 01 01 05 00 00 00 00 00 00 00 00 00 00 00 00 00 00 00 00 00 00 00 00 00 00 00 00 00 00 00 00 00 00 00 00 00 00 09
10 02 00 00 00 00 00 00 00 00 00 00 00 00 00 00 00 00 00 00 16 15 15 15 15 15 15 22 15 15 17 06 00 00 00 00 00 00 00 00 00 00 00 00 00 00 00 00 00 09
10 02 00 00 18 06 00 00 18 06 00 00 00 00 00 00 00 00 00 00 04 01 01 01 01 01 01 19 23 01 01 05 00 00 00 00 00 00 00 00 00 00 00 00 00 00 00 00 00 09
10 02 00 00 19 02 00 00 19 02 00 00 18 06 00 00 00 00 00 00 00 00 00 00 00 00 00 19 02 00 00 00 00 00 00 00 00 00 00 00 00 00 00 00 00 00 00 00 00 09
10 02 00 00 19 02 00 00 19 02 00 00 19 02 00 00 00 18 06 00 00 00 00 00 00 00 00 19 02 00 00 00 00 00 00 00 00 00 00 00 00 00 00 00 00 00 00 00 00 09
10 02 00 00 19 02 00 00 19 02 00 00 19 02 00 00 00 19 02 00 00 00 00 00 00 00 00 19 02 00 00 00 00 00 00 00 00 00 00 00 00 00 00 00 00 00 00 00 00 09
10 02 00 00 19 02 00 00 19 02 00 00 19 02 00 00 00 19 02 00 00 00 00 00 00 00 00 19 02 00 00 00 00 00 00 16 15 15 15 22 15 15 15 15 15 17 06 00 00 09
10 02 00 00 19 02 00 00 19 02 00 00 20 02 00 00 00 19 02 00 00 00 00 00 00 00 00 19 02 00 00 00 00 00 00 04 01 01 01 19 23 01 01 01 01 01 05 00 00 09
10 02 00 00 19 02 00 00 19 02 00 00 04 05 00 00 00 19 02 00 00 00 00 00 00 00 00 19 02 00 00 00 00 00 00 00 00 00 00 19 02 00 00 00 00 00 00 00 00 09
10 02 00 00 19 02 00 00 19 02 00 00 00 00 00 00 00 19 02 00 00 00 00 00 00 00 00 19 02 00 00 00 00 00 00 00 00 00 00 19 02 00 00 00 00 00 00 00 00 09
10 02 00 00 19 02 00 00 25 15 15 15 15 15 15 15 15 21 15 15 17 06 00 00 00 00 00 20 02 00 00 00 00 00 00 00 00 00 00 19 02 00 00 00 00 00 00 00 00 09
10 02 00 00 19 02 00 00 19 23 01 01 01 01 01 01 01 01 01 01 01 05 00 00 00 00 00 04 05 00 00 00 00 00 00 00 00 00 00 19 02 00 00 00 00 00 00 00 00 09
10 02 00 00 19 02 00 00 19 02 00 00 00 00 00 00 00 00 00 00 00 00 00 00 00 00 00 00 00 00 00 00 00 00 00 00 00 00 00 19 02 00 00 00 00 00 00 00 00 09
10 02 00 00 19 02 00 00 19 02 00 00 00 00 00 00 00 00 00 00 00 00 00 00 00 00 00 00 00 00 00 00 16 15 15 15 15 15 15 24 02 00 00 00 00 00 00 00 00 09
10 02 00 00 19 02 00 00 20 02 00 00 00 00 00 00 00 00 00 00 00 00 00 00 00 00 00 00 00 00 00 00 04 01 01 01 01 01 01 19 02 00 00 00 00 00 00 00 00 09
10 02 00 00 19 02 00 00 04 05 00 00 00 00 16 15 15 15 15 15 22 15 15 17 06 00 00 00 00 00 00 00 00 00 00 00 00 00 00 19 02 00 00 00 00 00 00 00 00 09
10 02 00 00 19 02 00 00 00 00 00 00 00 00 00 00 00 00 00 00 19 23 01 01 05 00 00 00 00 00 00 00 00 00 00 00 00 00 00 19 02 00 00 00 00 00 00 00 00 09
10 02 00 00 19 02 00 00 00 00 00 00 00 00 00 00 00 00 00 00 19 02 00 00 00 00 00 00 00 00 00 00 00 00 00 00 00 00 00 19 02 00 00 00 00 00 00 00 00 09
10 02 00 00 19 02 00 00 00 00 00 00 00 00 00 00 00 00 00 00 19 02 00 00 00 00 00 00 00 00 00 16 15 15 15 15 15 15 15 21 15 15 15 15 15 15 17 06 00 09
10 02 16 15 21 15 15 15 15 15 15 15 15 15 17 06 00 00 00 00 19 02 00 00 00 00 00 00 00 00 00 04 01 01 01 01 01 01 01 01 01 01 01 01 01 01 01 05 00 09
10 02 04 01 01 01 01 01 01 01 01 01 01 01 01 05 00 00 00 00 19 02 00 00 00 00 00 00 00 00 00 00 00 00 00 00 00 00 00 00 00 00 00 00 00 00 00 00 00 09
10 02 00 00 00 00 00 00 00 00 00 00 00 00 00 00 00 00 00 00 19 02 00 00 00 00 00 00 00 00 00 00 00 00 00 00 00 00 00 00 00 00 00 00 00 00 00 00 00 09
10 02 00 00 00 00 00 00 00 00 00 00 00 00 00 00 00 00 00 00 19 02 00 00 00 00 00 00 00 00 00 00 00 00 00 00 00 00 00 00 00 00 00 00 00 00 00 00 00 09
10 02 00 00 00 00 00 00 00 00 00 00 00 00 00 00 00 00 00 00 25 15 15 15 15 15 22 15 17 06 00 00 00 00 00 00 00 00 00 00 00 00 00 00 00 00 00 00 00 09
10 02 00 00 00 00 00 00 00 00 00 00 00 00 00 00 00 00 00 00 19 23 01 01 01 01 19 23 01 05 00 00 00 00 00 00 00 00 00 00 00 00 00 00 00 00 00 00 00 09
10 02 00 00 00 00 00 00 00 00 00 00 00 00 00 00 00 00 00 00 19 02 00 00 00 00 19 02 00 00 00 00 00 00 00 00 00 00 00 00 00 00 00 00 00 00 00 00 00 09
10 02 00 00 00 00 00 00 00 00 00 00 00 00 00 00 00 00 00 00 19 02 00 00 00 00 19 02 00 00 00 00 00 00 00 00 00 00 00 00 00 00 00 00 00 00 00 00 00 09
10 02 00 00 00 00 00 00 00 00 00 00 00 00 00 00 00 00 00 00 19 02 00 00 00 00 19 02 00 00 00 00 00 00 00 00 00 00 00 00 00 00 00 00 00 00 00 00 00 09
10 02 00 00 00 00 00 00 00 00 00 00 00 00 00 00 00 00 00 00 19 02 00 00 00 00 19 02 00 00 00 00 00 00 00 00 00 00 00 00 00 00 00 00 00 00 00 00 00 09
10 02 00 00 00 00 00 00 00 00 00 00 00 00 00 00 00 00 00 00 20 02 00 00 00 00 19 02 00 00 00 00 00 00 00 00 00 00 00 00 00 00 00 00 00 00 00 00 00 09
10 02 00 00 00 00 00 00 00 00 00 00 00 00 00 00 00 00 00 00 04 05 00 00 00 00 20 02 00 00 00 00 00 00 00 00 00 00 00 00 00 00 00 00 00 00 00 00 00 09
10 02 00 00 00 00 00 00 00 00 00 00 00 00 00 00 00 00 00 00 00 00 00 00 00 00 04 05 00 00 00 00 00 00 00 00 00 00 00 00 00 00 00 00 00 00 00 00 00 09
10 02 00 00 00 00 00 00 00 00 00 00 00 00 00 00 00 00 00 00 00 00 00 00 00 00 00 00 00 00 00 00 00 00 00 00 00 00 00 00 00 00 00 00 00 00 00 00 00 09
10 02 00 00 00 00 00 00 00 00 00 00 00 00 00 00 00 00 00 00 00 00 00 00 00 00 00 00 00 00 00 00 00 00 00 00 00 00 00 00 00 00 00 00 00 00 00 00 00 09
10 02 00 00 00 00 00 00 00 00 00 00 00 00 00 00 00 00 00 00 00 00 00 00 00 00 00 00 00 00 00 00 00 00 00 00 00 00 00 00 00 00 00 00 00 00 00 00 00 09
10 02 00 00 00 00 00 00 00 00 00 00 00 00 00 00 00 00 00 00 00 00 00 00 00 00 00 00 00 00 00 00 00 00 00 00 00 00 00 00 00 00 00 00 00 00 00 00 00 09
10 02 00 00 00 00 00 00 00 00 00 00 00 00 00 00 00 00 00 00 00 00 00 00 00 00 00 00 00 00 00 00 00 00 00 00 00 00 00 00 00 00 00 00 00 00 00 00 00 09
10 02 00 00 00 00 00 00 00 00 00 00 00 00 00 00 00 00 00 00 00 00 00 00 00 00 00 00 00 00 00 00 00 00 00 00 00 00 00 00 00 00 00 00 00 00 00 00 00 09
10 02 00 00 00 00 00 00 00 00 00 00 00 00 00 00 00 00 00 00 00 00 00 00 00 00 00 00 00 00 00 00 00 00 00 00 00 00 00 00 00 00 00 00 00 00 00 00 00 09
10 02 00 16 15 15 15 27 06 26 15 15 15 17 06 00 00 00 00 00 00 00 00 00 00 00 00 00 00 00 00 00 00 00 00 00 00 00 00 00 00 00 00 00 00 00 00 00 00 09
10 02 00 04 01 01 01 01 05 04 01 01 01 01 05 00 00 00 00 00 00 00 00 00 00 00 00 00 00 00 00 00 00 00 00 00 00 00 00 00 00 00 00 00 00 00 00 00 00 09
10 02 00 00 00 00 00 00 00 00 00 00 00 00 00 00 00 00 00 00 00 00 00 00 00 00 00 00 00 00 00 00 00 00 00 00 00 00 00 00 00 00 00 00 00 00 00 00 00 09
10 02 00 00 00 00 00 00 00 00 00 00 00 00 00 00 00 00 00 00 00 00 00 00 00 00 00 00 00 00 00 00 00 00 00 00 00 00 00 00 00 00 00 00 00 00 00 00 00 09
10 02 00 00 00 00 00 00 00 00 00 00 00 00 00 00 00 00 00 00 00 00 00 00 00 00 00 00 00 00 00 00 00 00 00 00 00 00 00 00 00 00 00 00 00 00 00 00 00 09
10 02 00 00 00 00 00 00 00 00 00 00 00 00 00 00 00 00 00 00 00 00 00 00 00 00 00 00 00 00 00 00 00 00 00 00 00 00 00 00 00 00 00 00 00 00 00 00 00 09
12 08 08 08 08 08 08 08 08 08 08 08 08 08 08 08 08 08 08 08 08 08 08 08 08 08 08 08 08 08 08 08 08 08 08 08 08 08 08 08 08 08 08 08 08 08 08 08 08 11